a : белгисиз артикль : неопределенный артикль
a few : бир нече : несколько
a great deal of : көп : много
about : жөнүндө : о
above : жогоруда : над, выше, наверху
absent : жок : отсутствующий
accept : кабыл алуу : принимать
accepted : кабыл алынган : принятый
accompanying : коштоп жүрүүчү : сопровождающий
account : эсеп : счет
ache : оору : боль
achievement : жетишкендик : выполнение
acre : акр : акр
actor : актер : актер
actress : актриса : актриса
actual : актуалдуу : текущий, современный
address : дареги : адрес, обращение
adjust : тууралоо : регулировать
administrator : администратор : администратор
admirable : суктанарлык : замечательный
admire : суктануу : восхищаться
admired : суктанган : восхищался
admission : кабыл алуу : допуск, вход
admittance : кабыл алуу : впуск, доступ
ads : жарнамалар : реклама
adult : бойго жеткен : взрослый
adults : чоңдор : взрослые
advance : алдын ала : продвижение
adventure : приключение : приключение
advertisement : жарнама : объявление
advice : кеңеш : совет
advise : кеңеш берүү : советовать
aerobics : аэробика : аэробика
afford : берем : позволить себе
afraid : коркуп : испуганный
after : кийин : после
afternoon : түштөн кийин : после полудня
again : кайра : снова
against : каршы : против
ago : мурун : (какое-то время) назад
agree : макул : соглашаться
agreed : макулдашты : согласился
agreement : макулдашуу : согласие, соглашение
agricultural : айыл чарба : сельскохозяйственный
ahead : алдыда : вперед
aids : жардам берет : вспомогательные средства
air : аба : воздух
airport : аэропорт : аэропорт
airsick : аба оорусу : страдающий от воздушной болезни
all : баары : все, весь
allround : ар тараптан : всесторонний
allergy : аллергия : аллергия
allowance : пособие : дозволение, допущение
alone : жалгыз : один, одинокий
aloof : алыс : поодаль, вдали
already : уже : уже
also : ошондой эле : тоже, также
alternative : альтернатива : альтернатива, выбор
always : ар дайым : всегда
am : ам : есть
amount : сумма : количество, сумма
amuse : көңүл ачуу : смешить
an : а : неопределенный артикль
and : жана : и, а
anger : ачуулануу : гнев, злость
angry : ачуулуу : сердитый
announce : жарыялоо : объявлять
announced : жарыялады : объявлял, объявленный
another : башка : еще один, другой
answer : жооп : ответ, отвечать
answered : деп жооп берди : ответил
any : каалаган : какой-либо, любой
any where : каалаган жерде : куда-нибудь
anyone : кимдир бирөө : кто-то, кто угодно
anything : эч нерсе : что-то, что угодно
apartment : батир : квартира
apiece : бир кесим : за штуку, поштучно
apologies : кечирим сурайм : извинения
apologize : кечирим сура : извиняться
apology : кечирим суроо : извинение
appear : пайда болот : появляться
appeared : пайда болду : появлялся
appetizer : аппетит : закуска
apple : алма : яблоко
apples : алма : яблоки
apply : колдонуу : обращаться, применять
appointment : дайындоо : условленная встреча
approval : бекитүү : одобрение
approve : бекитүү : одобрять
April : Апрель : апрель
architect : архитектор : архитектор
are : болуп саналат : есть
area : аймак : площадь, район
argue : талашуу : спорить
argument : аргумент : спор
around : айланасында : вокруг, по
arrival : келүү : прибытие
arrive : келүү : приезжать
arrived : келди : приехал, прибыл
arriving : келүү : прибывающий
art : ст : искусство
artful : көркөм : хитрый, ловкий
article : макала : предмет, изделие
articles : макалалар : предметы
as : катары : как, так, в то время как
as far as : андыктан : насколько
as for : үчүн : что касается
ashore : жээкке : на берег
aside : четте : в сторону
ask : сура : просить, спрашивать
asked : деп сурады : просил, требовал
asking : сурап : спрашивающий
asks : деп сурайт : спрашивает
at : саат : в, у
at once : бир жолу : сразу, сейчас же
ate : жеди : съел
attend : катышуу : посещать, обслуживать
attended : катышты : обслуженный, обслужил
audience : аудитория : публика
August : Август : август
automobile : автомобиль : автомобиль
autumn : күз : осень
available : жеткиликтүү : доступный
away : алыс : прочь
back : артка : спина, назад
bacon : бекон : бекон
bad : жаман : плохой
badly : жаман : сильно, плохо
bag : сумка : сумка
baggage : багаж : багаж
bags : сумкалар : сумки, багаж
ballet : балет : балет
banana : банан : банан
bananas : банан : бананы
band : топ : лента, ансамбль
bands : топтор : ансамбли
bank : банк : банк
bar : бар : бар
barber : чач тарач : парикмахер
barber’s : чач тарач : мужская парикмахерская
barrel : баррель : баррель
basketball : баскетбол : баскетбол
bath : ванна : ванна
bath tub : ванна : ванная
bathing : жуунуу : купание, купальный
battery : батарея : аккумулятор
be : бол : быть
be absent : жок болуу : отсутствовать
be afraid : коркуу : бояться
be fond of : сүйүү : любить
be ill : оорулуу болуу : болеть
be laid up : коюу : лежать больным
be late : кечигүү : опаздывать
be out of sorts : түрү жок болуу : плохо себя чувствовать
be vexed with : таарынуу : сердитый на (кого-либо)
beach : пляж : пляж
beans : буурчак : фасоль
beautiful : сулуу : красивый
beauty : сулуулук : красота, косметический
became : болуп калды : становился, стал
become : болуу : становиться
becomes : болуп калат : становится
becoming : болуу : идущий (к лицу)
bed : керебет : постель
bedding : төшөк : спальные принадлежности
bedroom : уктоочу : спальня
bedsheet : шейшеп : простыня
beef : уй эти : говядина
beefsteak : бифштекс : бифштекс
been : болгон : форма глагола от be
beer : сыра : пиво
beet : кызылча : свекла
before : мурун : перед, до того как
beg : жалбаруу : просить, умолять
began : баштады : начинал, начал
begin : баштоо : начинать (ся)
begins : башталат : начинается
behave : жүрүм-туруму : вести себя
behaviour : жүрүм-турум : поведение
behind : артында : позади
being : болуу : будучи
believe : ишенүү : верить
believed : ишенген : верил, полагал
bell : коңгуроо : звонок
belt : кур : пояс, ремень
berries : жемиштер : ягоды
berry : мөмө : ягода
beside : жанында : вне себя, мимо
best : мыкты : наилучший
better : жакшыраак : лучше
between : ортосунда : между
beware : сак бол : осторожно
beyond : ары : вне, сверх
big : чоң : большой
bike : велосипед : велосипед
bill : мыйзам долбоору : счет, законопроект
biology : биология : биология
birth : төрөлүү : рождение
birthday : туулган күн : день рождения
bit : бит : кусочек, немного
black : кара : черный
blade : бычак : лезвие
blanket : жууркан : одеяло
block : блок : блок, квартал
blocks : блоктор : кварталы
blood : кан : кровь
blouse : койнок : блуза
blue : көк : синий
board : такта : доска
boarding : отуруу : посадка
boat : кайык : лодка, пароход
boating : кайык менен жүрүү : катание на лодке
body : дене : тело
body building : дене куруу : культуризм
boiled : кайнатылган : вареный, кипяченый
bonus : бонус : премия
book : китеп : книга, покупать
booking : ээлөө : продажа билетов
booking office : брондоо кеңсеси : билетная касса
books : китептер : книги
bookstore : китеп дүкөнү : книжный магазин
boot : жүктөө : ботинок, сапог
booth : кабина : кабинка
boots : өтүктөр : ботинки, сапоги
bore : тажоо : скука
boring : кызыксыз : скучный
born : туулган : рожденный
borrow : карыз алуу : брать в долг
borrowed : карыз алган : взятый в долг
boss : босс : начальник
both : экөө тең : оба
bottle : бөтөлкө : бутылка
bottles : бөтөлкөлөр : бутылки
bought : сатып алды : купил, купленный
bound : байланган : непременный, обязательный
bounds : чектер : граница, ограничение
box : куту : ящик, ложа (театр.)
boxes : кутулар : ложи
boy : бала : мальчик, юноша
brace : кашаа : связывать, скреплять
bracelet : билерик : браслет
brake : тормоз : тормоз
brakes : тормоздор : тормоза
brass : жез : установить
brawl : мушташ : уличный скандал
bread : нан : хлеб
break : тыныгуу : ломать
breakfast : эртең мененки тамак : завтрак
breathe : дем алуу : дышать
breed : тукум : порода
brew : демдөө : затевать, надвигаться
brewing : кайнатуу : затевающий, надвигающийся
brief : кыскача : короткий, сводка, резюме
bright : жарык : ясный
bring : алып кел : приносить, приводить
Britain : Британия : Британия
British : Британ : британский
broadcast : берүү : передача
broke : сынды : (c)ломал, сломанный
bronze : коло : бронзовый
brooch : брошь : брошь
brother : байке, ини : брат
brought : алып келди : принес, принесенный
brown : күрөң : коричневый
build : куруу : строить
building : имарат : здание
built : курулган : строил, построенный
burst : жарылуу : заливаться, раздражаться
bus : автобус : автобус
business : бизнес : бизнес, дело
businessman : бизнесмен : бизнесмен
businessmen : бизнесмендер : бизнесмены
busy : алек : занятой
but : бирок : но
butter : май : масло
buy : сатып алуу : покупать, купить
by : тарабынан : по, при, путем
bye : кош болуңуз : пока (при прощании)
cabbage : капуста : капуста
cabin : кабина : каюта
cable : кабель : кабельный
café : кафе : кафе
cafeteria : кафетерия : буфет
cake : торт : торт
call : чалуу : звонить, называть
call a spade a spade : бир күрөк чалуу : называть своими именами
called : чакырды : звонил, названный
calling : чакыруу : звонящий
calm : тынч : успокаивать
came : келди : пришел (от come)
came back : кайтып келген : вернулся, возвращался
camera : камера : фотоаппарат
can : болот : уметь, мочь
can’t : мүмкүн эмес : не уметь
candidate : талапкер : кандидат
cannot : мүмкүн эмес : не уметь
cap : кап : шапка
captain : капитан : капитан
car : машина : машина
car service station : унааларды тейлөө станциясы : станция техобслуживания
card : карта : карточка
cardinal : кардинал : количественный
cards : карталар : карточки
care : кам көрүү : заботиться, переживать
career : мансап : профессия, карьера
careers : карьера : профессии
careful : сак : осторожный
cares : кам көрөт : заботится, переживает
carriage : вагон : вагон
carry : алып жүрүү : нести, носить, возить
carton : картон : коробка
cartoon : мультфильм : мультфильм
case : иш : чехол, футляр
cash : накталай акча : деньги
casino : казино : казино
cassette : кассета : кассета
cat : мышык : кошка
catcall : чакыруу : освистывать
catcalls : чакырат : освистывает
catch : кармоо : уловить, понять
caution : сак : осторожность
caviar : икра : икра
celebrate : майрамдоо : праздновать
celebrated : майрамдады : праздновал
center : Борбор : центр
centimetre : сантиметр : сантиметр
central : борбордук : центральный
centre : Борбор : центр
cent : цент : цент
century : кылым : столетие, век
certainly : албетте : конечно
certificate : күбөлүк : справка, аттестат
chambermaid : палата кызматчысы : горничная
champagne : шампан : шампанское
champion : чемпион : чемпион
chance : кокустук : случай, шанс
change : өзгөртүү : мелкие деньги, сдача
changed : өзгөрдү : поменял, изменил
changes : өзгөрүүлөр : меняется
channel : канал : канал
charge : заряд : плата, стоимость
charges : айыптар : издержки, расходы
chasing : кууп : уклоняющийся
chasing hares : коёндорду кууп : уклоняющийся
chat : чат : беседа, болтовня
chatterbox : баарлашуу : болтунья
cheap : арзан : дешевый
cheaper : арзаныраак : подешевле
check : текшерүү : проверять, регистрировать
check in : каттоого киргизүү : регистрация
check out : текшерүү : выписаться
cheer : кубануу : утешать
cheerio : жолуңуз ачык болсун : всего хорошего, пока
cheers : Ура : да здравствует
cheese : сыр : сыр
chemistry : химия : химия
cherries : алча : вишни
cherry : алча : вишня
chess : шахмат : шахматы
chicken : тоок : цыпленок, кура
chief : начальник : шеф, начальник
child : бала : ребенок
children : балдар : дети
children’s : балдардын : детский
china : кытай : фарфор
choice : тандоо : выбор
choir : хор : хор
choose : тандоо : выбирать
chose : тандады : выбирал, выбрал
chosen : тандалды : выбранный
Christmas : Нартууган : рождество
cigarette : тамеки : сигарета
cigarettes : тамеки : сигареты
cinema : кино : кино
circle : тегерек : окружность, круг
circumstance : жагдай : обстоятельство, условие
citizen : жаран : гражданин
city : шаар : город
claim : доомат : требовать
class : класс : класс
classical : классикалык : классический
clean : таза : чистить, чистый
cleaned : тазаланган : чистил, (по)чищенный
cleaning : тазалоо : чистка
clear : ачык : ясный, светлый, очищать
cleared : тазаланды : рассчитался
clever : акылдуу : умный
climate : климат : климат
cloakroom : гардероб : гардероб
clock : саат : часы
close : жакын : закрывать (ся)
closed : жабык : закрыл, закрытый
clothes : кийим : одежда
clothing : кийим : одежда
club : клуб : клуб
coach : машыктыруучу : автобус, купе
coat : пальто : пальто
code : код : код
coffee : кофе : кофе
cognac : коньяк : коньяк
coin : тыйын : монета
coincidence : кокустук : совпадение
coins : тыйындар : монеты
cold : суук : холод, холодный
colder : муздак : холоднее
collar : жака : воротник
collect : чогултуу : коллекционировать
collected : чогултулган : коллекционировал
collection : чогултуу : коллекция
collections : коллекциялар : собирание, выемка
college : колледж : колледж
colorful : түстүү : красочный
colour : түс : цвет
colours : түстөр : цвета
column : тилке : графа, отдел
come : кел : приходить, приезжать
comedy : комедия : комедия
comfortable : ыңгайлуу : удобный
comics : комикс : комиксы
coming : келе жатат : приход, приходящий
commission : комиссия : комиссионные
compact : компакттуу : компактный
compare : салыштыруу : сравнивать
compared : салыштырылган : сравнил
compartment : купе : купе
competition : атаандаштык : соревнование
competitions : мелдештер : соревнования
complaint : арыз : жалоба
complaints : даттануулар : жалобы
completely : толугу менен : совершенно
complicated : татаал : сложный
compliment : комплимент : комплимент
compliments : комплимент : комплименты
composer : композитор : композитор
comprehensive : комплекстүү : богатый
compulsory : милдеттүү : обязательный
computer : компьютер : компьютер
concert : концерт : концерт
concerts : концерттер : концерты
condole : көңүл айтуу : соболезновать
congratulate : куттуктайм : поздравлять
congratulation : куттуктоо : поздравление
congratulations : куттуктайбыз : поздравления
congratulated : куттуктады : поздравил
cons : терс жактары : против
conservatoire : консерватория : консерватория
consider : карап көрөлү : считать
consist : турат : состоять
consists : турат : состоит
consolation : жубатуу : утешение
consulate : консулдук : консульство
consult : кеңешүү : советоваться
contact : байланыш : устанавливать связь
continental : континенталдык : континентальный
continue : улантуу : продолжать (ся)
continued : улантты : продолжал
contributor : салым кошуучу : сотрудник
control : контролдоо : контроль, управление
conveniences : ыңгайлуулуктар : удобства
conversation : сүйлөшүү : разговор, беседа
cook : ашпозчу : готовить, повар
cooked : бышырылган : готовил
cool : баракелде : прохладный
cooler : муздаткыч : холоднее
cooperation : кызматташтык : сотрудничество
cooperative : кооператив : кооперативный
cord : шнур : шнур
corn : жүгөрү : кукуруза
corn-flakes : жүгөрү үлпектери : кукурузные хлопья
corner : бурч : угол
correspondence : кат алышуу : корреспонденция
cost : наркы : стоить, стоил
cosy : ыңгайлуу : уютный
cottage : коттедж : коттедж
cotton : пахта : хлопок
cough : жөтөл : кашель
could : мүмкүн : мог, могли (бы)
couldn’t : мүмкүн эмес : не мог
count : сана : считать
count in : сана : включать
count out : санап чыгуу : исключать, опускать
countries : өлкөлөр : страны
country : өлкө : страна
course : албетте : курс, блюдо
courses : курстар : блюда
court : сот : корт, двор
cousin : бөлө - from mother side : двоюродный брат
coverage : камтуу : охват, репортаж
crab : краб : краб
crack : жарака : попытка, проба
cream : каймак : сливки, крем
credit : кредит : кредит
crew : экипаж : судовая команда, экипаж
crime : кылмыш : преступление, преступность
criticize : сындоо : критиковать
criticized : сынга алды : критиковал
cross : кайчылаш : пересекать
crossing : өтүү : переход
cry : ыйла : кричать, восклицать
cry for the moon : ай үчүн ыйлоо : требовать невозможного
crystal : кристалл : хрусталь
cubic : куб : кубический
cucumber : бадыраң : огурец
cucumbers : бадыраң : огурцы
cup : чөйчөк : чашка
cups : чөйчөктөр : чашки
curds : быштак : творог
currency : валюта : валюта
customs : бажы : таможня
customs officer : Бажы кызматкери : таможенник
cut : кесип : разрез, фасон
cut : кесип : (раз)резать, (раз)резал
cut and dried : кесип жана кургатылган : заранее подготовленный
cutlet : котлет : котлета
cutlets : котлеттер : котлеты
dance : бийле : танцевать
danced : бийлеген : танцевал
dancing : бийлөө : танцы
danger : коркунуч : опасность
dangerous : коркунучтуу : опасный
dare : батын : сметь, отважиться
date : дата : дата
dates : даталар : даты
daughter : кыз : дочь
daughters : кыздары : дочери
day : күн : день
days : күн : дни
deal : келишим : значительное количество
dear : кымбаттуу : дорогой
debt : карыз : долг
debts : карыздар : долги
December : Декабрь : декабрь
decide : чеч : решать
decided : чечти : решил
deck : палуба : палуба
declaration : декларация : декларация
declare : жарыялоо : декларировать
deeply : терең : глубоко
delayed : кечиктирилген : отложен
delegation : делегация : делегация
delight : ырахат : восхищение, восхищаться
delighted : сүйүнгөн : восхищался
deliver : жеткирүү : доставлять, передавать
delivered : жеткирилди : доставил
delivery : жеткирүү : доставка
demand : талап : требовать
demanded : талап кылды : требовал
dentist : тиш доктур : зубной врач
department : бөлүм : отдел
departments : бөлүмдөр : отделы, отделения
departure : кетүү : отъезд, отправление
departures : кетүүлөр : отправление
deposit : депозит : взнос, вклад
deposits : депозиттер : прием багажа
desire : каалоо : желание
dessert : десерт : десерт
destination : көздөгөн жер : место назначения
detective : детектив : детектив (ный)
develop : иштеп чыгуу : развивать
developed : иштелип чыккан : развил
devil : шайтан : дьявол, сатана
dial : терүү : набирать номер
dictaphone : диктофон : диктофон
did : кылды : делал, действовал
didn’t : жок : не делал, не действовал
die : өлүү : умирать
died : каза болгон : умер, умерший
diet : диета : диета
difference : айырма : разница, различие
different : башкача : другой, отличный от
difficult : кыйын : трудный
dime : тыйын : дайм (центов)
dine : тамактануу : обедать
dining : тамактануу : обеденный
dining car : тамактануучу машина : вагон-ресторан
dining room : ашкана бөлмө : столовая
dinner : кечки тамак : обед
diplomatic : дипломатиялык : дипломатический
direct : түз : прямой, руководить
direction : багыт : направление
director : директор : режиссер
directory : каталог : справочник
disadvantage : кемчилик : неудобство
disagreement : келишпестик : несогласие
disappoint : көңүл калтыруу : разочаровывать
disappointed : көңүлү калган : разочарованный
disappointment : көңүл калуу : разочарование
disappointing : көңүл калтыруучу : печальный
disapproval : жактырбоо : неодобрение
disapprove : жактырбоо : не одобрять
disbelief : ишенбестик : недоверие
disc : диск : диск
disconnected : ажыратылган : разъединенный
discord : келишпестик : разногласие, раздоры
discotheque : дискотека : дискотека
discotheques : дискотекалар : дискотеки
discount : арзандатуу : скидка
discs : дисктер : диски
discuss : талкуулоо : обсуждать
discussed : талкууланды : обсуждал
discussing : талкуулоо : обсуждающий
discussion : талкуу : беседа
disgraceful : уятсыз : позорный
dish : тамак : блюдо
district : райондук : район
dive : сууга түшүү : нырять
diving : дайвинг : ныряние
divorced : ажырашкан : разведенный
do : кыл : делать, действовать
doctor : дарыгер : доктор, врач
doctor’s : врачтык : докторский, врачебный
does : кылат : делать, действовать
doesn’t : жок : не делает, не действует
dog : ит : собака
doing : кылып жатат : делающий
doll : куурчак : кукла
dollar : доллар : доллар
dollars : доллар : доллары
don’t : кылба : не делаю, не действую
done : аткарылды : сделанный
door : эшик : дверь
double : кош : двойной, на двоих
double bedded : эки керебет : имеющий две кровати
doubt : күмөн : сомнение, сомневаться
down : төмөн : внизу, вниз
downpayment : баштапкы төлөм : задаток
drama : драма : драма
drank : ичти : (вы)пил
draw : тартуу : рисовать
drawn : тартылган : нарисованный
dream : кыял : мечтать, видеть сны
dreamt : кыялданган : мечтал
dress : кийим : платье, одеваться
dress circle : кийим чөйрөсү : бельэтаж
dressing : кийинүү : приправа
drew : тартты : рисовал
drink : ичүү : напиток, пить
drinks : суусундуктар : напитки
drive : айда : водить машину
driver : айдоочу : водитель, шофер
driver’s : айдоочунун : водительский
driving at : айда : метящий
drop : таштоо : капля, падать, ронять
drop in : кир : заходить
drove : айдады : водил машину
drugstore : дарыкана : аптека
drunk : мас : выпитый, пьяный
dry : кургак : сухой
duck : өрдөк : утка
due : төлөнүүчү : должный, обязанный
dull : бүдөмүк : скучный
during : учурунда : во время
duty : милдет : долг, обязанность
duty free : алымсыз : беспошлинный
dye : боёк : красить, краска
dyed : боёлгон : крашенный
dying : өлүп жатат : погибающий
eager : дилгир : нетерпеливый
earache : кулак оору : боль в ухе
early : эрте : рано
earrings : сөйкөлөр : серьги
earth : жер : земля
easily : оңой : легко
east : чыгыш : восток, восточный
easy : жеңил : легкий, простой
eat : же : есть
eater : жегич : едок
eating : тамактануу : прием пищи, еда
economist : экономист : экономист
economy : экономика : экономика
edgeways : четтери : острием
editor : редактор : редактор
education : билим берүү : образование
egg : жумуртка : яйцо
eggs : жумуртка : яйца
eight : сегиз : восемь
eighteen : он сегиз : восемнадцать
eighth : сегизинчи : восьмой
eighty : сексен : восемьдесят
either : же : или
electric : электр : электрический
electricity : электр энергиясы : электричество
electronics : электроника : электроника
elevator : лифт : лифт
eleven : он бир : одиннадцать
embassy : элчилик : посольство
emergency : өзгөчө кырдаал : крайняя необходимость
empty : бош : пустой
end : бүтүү : конец
engage : тартуу : нанимать, занимать
engaged : алектенген : занятый, помолвленный
engine : мотор : двигатель, мотор
engineer : инженер : инженер
English : Англисче : английский язык
enjoy : ырахат алуу : любить, наслаждаться
enjoyed : ырахат алды : получил удовольствие
enough : жетишет : достаточный
enter : кирүү : входить, поступать
entered : кирди : поступил
entertainment : көңүл ачуу : развлечение
enthusiastic : энтузиаст : восторженный
entrance : кире бериш : вход
entry : кирүү : вход
envelope : конверт : конверт
equality : теңдик : равенство, равноправие
equipment : жабдуулар : снаряжение, оборудование
European : европалык : европейский
even : ал тургай : даже
evening : кечинде : вечер
evenings : кечинде : вечерние спектакли
ever : эч качан : когда-либо
every : ар : каждый
everybody : баары : каждый, всякий, все
everybody’s : ар кимдики : каждого, всеобщее
everyday : күн сайын : повседневный
everything : баары : все
exactly : так : точно, именно
exam : экзамен : экзамен
examination : экспертиза : экзамен
exams : экзамендер : экзамены
excellent : сонун : превосходный, отличный
exchange : алмашуу : обмен, обменивать
exchanged : алмашкан : обменивал (от exchange)
exciting : кызыктуу : волнующий, великолепный
excuse : кечирүү : извинять
exhibition : көргөзмө : выставка
exit : чыгуу : выход, выезд
expect : күтүү : ожидать
expectation : күтүү : ожидание
expectations : күтүүлөр : ожидания (от expectation)
expecting : күтүүдө : ожидающий (от expect)
expense : чыгаша : расход
expensive : кымбат : дорогой
experience : тажрыйба : опыт
expert : эксперт : эксперт
explain : түшүндүрүү : объяснять
explained : түшүндүрдү : объяснил
express : экспресс : экспресс, выражать
expressing : билдирүү : выраженный
expression : билдирүү : выразительность, выражение
extend : узартуу : продлевать, растягивать
external : тышкы : наружный
extra : кошумча : сверх
extremely : абдан : крайне
eye : көз : глаз
eye-opener : көз Ачкыч : открывающее человеку глаза
eyepencil : көз карандаш : карандаш для век
face : жүзү : лицо
faces : жүздөр : выходит, стоит лицом
facing : караган : сидящий лицом
fact : факт : сущность, факт
factory : фабрика : фабрика, завод
failed : ишке ашкан жок : потерпел неудачу, не удалось
faintest : эң алсыз : малейший
fair : адилет : любезно, хорошо
fairly : адилеттүү : довольно
fairy : пери : волшебный
fairy-tales : жомоктор : сказки
fall : түшүү : падать
family : үй-бүлө : семья
famous : атактуу : известный
fancy : кооз : воображать, представлять себе
fantastic : фантастикалык : фантастический
far : алыс : далеко
fare : жол кире : плата за проезд
farmer : дыйкан : фермер
farther : алыс : дальше
fascinated : суктанган : очаровал
fashion : мода : мода
fashionable : модалуу : модный
fast : тез : спешащий, сильно
faster : тезирээк : быстрее
father : ата : отец
fault : күнөө : вина, недостаток
favour : жакшылык : одолжение, услуга
favourite : сүйүктүү : любимый
feather : мамык : достижение
February : Февраль : февраль
fed up : тойгон : насыщенный
fee : алым : гонорар, платить гонорар
feel : сезүү : чувствовать
feeling : сезим : чувство, чувствующий
feelings : сезимдер : страсти
fell : жыгылды : упал
felt : сезилди : чувствовал
fever : калтыратма : жар, лихорадка
few : аз : мало
fiction : фантастика : беллетристика, вымысел
fiddlesticks : скрипкалар : вздор
fifteen : он беш : пятнадцать
fifth : бешинчи : пятый
fifths : бештен : пятых
fifty : элүү : пятьдесят
fight : күрөш : бороться, бой
fill : толтуруу : заполнить, наполнить
filling : толтуруу : заполнение, наполнение
film : тасма : фотопленка, фильм
find : табуу : найти, находить
fine : жакшы : прекрасно, прекрасный
fine : жакшы : штрафовать
fined : айып салынган : штрафовал, оштрафованный
finish : бүтүрүү : конец, финиш
finished : бүттү : закончил
first : биринчи : первый
first-class : биринчи класс : первый класс
fish : балык : рыба
fishing : балык уулоо : рыбная ловля
fit : ылайыктуу : подходить, соответствовать
fits : туура келет : подходит
fitting : ылайыктуу : примерка
five : беш : пять
fix : оңдоо : починить, наладить
fixed : белгиленген : назначил
flabbergasted : таң калды : поражен, изумлен
flat : жалпак : квартира, плоский
flats : батирлер : квартиры
flew : учуп кетти : летал
flight : учуу : полет
floor : кабат : пол, этаж
floored : кабатталган : поставил в тупик, сразил
fly : учуу : летать
flying : учуу : летающий, летный
folk : фольк : народная
follow : ээрчи : следовать
fond : жакшы көрөм : пристрастный, любящий
foot : бут : нога, фут
football : футбол : футбол
footwear : бут кийим : обувь
for : үчүн : для, за, на
forbid : тыюу : запрещать
forecast : болжолдоо : прогноз
foreign : чет элдик : иностранный
forget : унут : забыть
forgive : кечир : прощать
forgot : унутуп калды : забыл
forgotten : унутулган : забытый
fork : айры : вилка
form : форма : бланк, форма
forms : формалары : формы
fortnight : эки жума : две недели
fortune : байлык : удача, счастье
forty : кырк : сорок
found : табылган : нашел, найденный
four : төрт : четыре
fourteen : он төрт : четырнадцать
fourth : төртүнчү : четвертый
foyer : фойе : фойе
frame : кадр : оправа, рамка
frames : алкактар : оправы, рамки
France : Франция : Франция
frankly : ачык айтканда : откровенно
free : бекер : свободный
freight : жүк ташуу : груз, грузовой
French : Франсузча : французский
Friday : Жума : пятница
fried : куурулган : жареный
friend : дос : друг
friendly : достук : дружеский
friends : достор : друзья
friendship : достук : дружба
from : тартып : от, из
fruit : жемиш : фрукты
fulfil : аткаруу : выполнить
full : толук : полный
full-time : толук убакыт : полная ставка
fun : кызыктуу : шутка, веселье
fur : мех : мех, шкура
fur-coat : пальто : шуба
furniture : эмерек : мебель
furs : мехтери : меха
gallon : галлон : галлон
gallons : галлон : галлоны
game : оюн : игра
games : оюндар : игры
gardening : багбанчылык : садоводство
gargle : чайкоо : полоскание
gargling : чайкоо : полоскающий
gas : газ : газ
gate : дарбаза : ворота, проход
gatecrashers : дарбазачылар : незваные гости
gates : дарбазалар : стойки
gave : берди : дал
general : генерал : общий
generosity : берешендик : великодушие
gentleman : мырза : джентльмен
gentlemen : мырзалар : господа
gents’ : мырзалар : мужской туалет
geography : география : география
get : алуу : получать, доставать
get a rise out of : көтөрүлүш алуу : раздразнить
get mad : жинденүү : рассердиться
gets : алат : действует
getting : алуу : передвижение
give : бер : давать
give a lift : көтөрүү : подвозить
given : берилген : данный
giving a lift : көтөрүү : подвозящий
glad : кубанычтуу : рад
glass : айнек : стакан, бокал
glasses : көз айнек : очки
glitter : жаркыраган : блеск, блестеть
glove : мээлей : перчатка
gloves : мээлейлер : перчатки
go : кет : идти
go in for : үчүн кириңиз : заниматься
go mushrooming : козу карындай болуп кет : ходить за грибами
god : кудай : бог, божество
goes : барат : идет
going : бара жатат : идущий
gold : алтын : золото, золотой
good : жакшы : хороший, добрый
Good heavens! : Жакшы асман! : Боже мой!
good-bye : кош болуңуз : до свидания
Goodness : Жакшылык : Господи!
goods : товарлар : товары
gossip : ушак : сплетня
got : алды : получил, полученный
got a rise out of : көтөрүлүп чыкты : раздразнил(и)
got mad : жинденип калды : рассердился
gracious : боорукер : милосердный
graduate : бүтүрүү : окончить учебное заведение
graduated : бүтүргөн : окончил
gram : грамм : грамм
grandchildren : неберелер : внуки
grapes : жүзүм : виноград
grasp : кармоо : понять, схватить
grass : чөп : трава
gratitude : ыраазычылык : благодарность
great : абдан жакшы : великий
greatest : эң улуу : самый большой
green : жашыл : зеленый
greet : саламдашуу : приветствовать
greeted : учурашты : приветствовал
greeting : саламдашуу : приветствие, поклон
greetings : салам : приветствия
grew : өстү : рос
grey : боз : серый
grief : кайгы : горе
grocery : азык-түлүк : гастроном (магазин)
grow : өсүү : расти
grown : өскөн : выращенный
guarantee : кепилдик : гарантия, гарантировать
guest : конок : гость
guests : коноктор : гости (от guest)
guide : гид : гид, экскурсовод
guitar : гитара : гитара
had : болгон : иметь
had a shot : атуу болгон : попробовал
hair : чач : волосы
hair-cut : чач кыркуу : стрижка
hair-dye : чач боёк : краситель для волос
hairdresser’s : чач тарач : женская парикмахерская
hairdresser : чач тарач : парикмахер
hairspray : чач лак : лак для волос
half : жарым : половина
halfpenny : жарым пенни : полпенни
ham : ветчина : ветчина
hamburger : гамбургер : гамбургер
hand : кол : рука
hand-brake : кол тормоз : ручной тормоз
handle : тутка : обращаться с , управлять
hands : колдору : руки
hanger : илгич : крюк, вешалка
hangers : илгичтер : вешалки, плечики
happen : болот : случаться, происходить
happened : болду : случился
happiness : бакыт : счастье
happy : бактылуу : счастливый
hard : кыйын : с трудом, тяжело
harder : кыйыныраак : больше, упорнее
harm : зыян : беда, неприятность
has : бар : имеет
hasn’t : жок : не имеет
hat : шляпа : шляпа
hate : жек көрүү : ненавидеть
hated : жек көргөн : ненавидел
have : бар : иметь, вспомогательный глагол
have a shot : атуу бар : сделать попытку
have got the wrong end of the stick : таяктын учун туура эмес : не угадал(и)
have you got…? : сенде…? : у вас есть…?
haven’t : жок : не иметь
having : ээ : имеющий, обладающий
he : ал : он
head : баш : голова, руководить
headache : баш оору : головная боль
headphones : кулакчындар : наушники
heads : баштары : головы
health : ден соолук : здоровье
health-club : ден соолук клубу : спортзал
hear : угуу : слышать
heard : укту : слушал, услышанный
heart : жүрөк : сердце
heater : жылыткыч : нагреватель
heating : жылытуу : отопление
heaven : асман : небо, небеса
heavy : оор : тяжелый
hectare : гектар : гектар
hell : тозок : черт
hello : салам : привет
help : жардам : помощь, помогать
helped : жардам берди : помогал
helpful : пайдалуу : полезный
helping : жардам берүү : помощь
her : анын : ее, ей
here : бул жерде : здесь, вот
Hermitage : Эрмитаж : Эрмитаж
herring : сельд : сельдь
hi : салам : привет
hi-fi : Жогорку сапаттуу : высшего класса
high : бийик : высокий
high-rise : бийик кабаттуу : высотный
higher : жогору : выше
highly : жогорку : очень, весьма
highways : автомобиль жолдору : шоссейные дороги
hiking : жөө жүрүш : пеший поход
him : ага : его, ему
himself : өзү : себя, себе
hippodrome : ипподром : ипподром
hire : жалдоо : взять напрокат
his : анын : его
historical : тарыхый : исторический
history : тарых : история
hit : сокку : успех, удача, попадать в цель
hobbies : хоббилери : увлечения, хобби
hobby : хобби : хобби
Hobson’s choice : Хобсондун тандоосу : отсутствие выбора
hockey : хоккей : хоккей
hold : кармоо : держать (ся), выдерживать
holder : кармоочу : владелец, ручка
holding : кармоо : удерживание, держащий
holiday : майрам : отпуск, праздник
holidays : майрамдар : каникулы
home : үй : дом
homes : үйлөр : дома
honour : урмат : честь
hope : үмүт : надеяться
hoped : үмүт кылган : надеялся
horse : ат : лошадь
horse-radish : ат-редиска : хрен
hose : шланг : чулки
hospital : оорукана : больница
hospitality : меймандостук : гостеприимство
host : хост : хозяин
hot : ысык : горячий
hotel : мейманкана : гостиница
hotter : ысык : жарче
hour : саат : час
hours : саат : часы
house : үй : дом
household : үй чарбасы : домашнее хозяйство
housewarming : конуш : празднование новоселья
how : кантип : как
HP (Horse Power) : HP (ат күчү) : лошадиная сила
humid : нымдуу : влажный
humidity : нымдуулук : влажность
humorous : тамашалуу : смешной
hundred : жүз : сто
hungry : ачка : голодный
hunting : аңчылык : охота
hurried : шашылды : спешил, торопился
hurry : шашыл : спешить, торопиться
hurt : зыян : рана, болеть
hurts : ооруйт : болеет, причиняет боль
husband : күйөө : муж
husband’s : күйөөсүнүн : мужа
I : И : я
I can’t make head or tail out of it : Мен андан баш же куйрук жасай албайм : ничего не понимаю
I’d : мен : я бы
I’d like to… : Мен каалайт элем… : я бы хотел (а)…
I’ll : мен кылам : я сделаю что-либо
I’m : Мен : I am
I’ve : Мен : I have
ice : муз : лед
ice-cream : балмуздак : мороженое
icebox : муз кутусу : холодильник
idea : идея : идея, мысль
if : эгерде : если
ignorance : наадандык : незнание, невежество
ill : оорулуу : больной
illustrated : иллюстрацияланган : иллюстрированный
imagine : элестетүү : думать, воображать
immediately : дароо : немедленно
import : импорттоо : импорт, ввоз
important : маанилүү : важный
impossible : мүмкүн эмес : невозможный
impressive : таасирдүү : впечатляющий
improbability : ыктымалсыздык : невероятность
improbable : мүмкүн эмес : невероятный
improve : жакшыртуу : улучшать
improved : жакшыртылган : улучшил
in : ичинде : в
in advance : алдын ала : заранее, вперед
in vain : бекер : напрасно
inch : дюйм : дюйм
include : камтыйт : включать
included : камтылган : включенный
income : киреше : доход, заработок
incomprehension : түшүнбөстүк : непонимание
incredible : укмуш : невероятно
indeed : Чындыгында : неужели, действительно
indifference : кайдыгерлик : безразличие
indigestion : тамак сиңирүү : несварение, расстройство
inevitability : кутулбастык : неизбежность
inferior : төмөн : худший, плохой
influence : таасири : влияние, влиять
influenced : таасир эткен : влиял
information : маалымат : информация
initial : баштапкы : начальный
inquiries : суроо : справочное
inquiry : суроо : расспросы
institute : институт : учреждать, основывать
interest : кызыгуу : интересовать
interested : кызыкдар : заинтересованный
interesting : кызыктуу : интересный
international : эл аралык : международный
interpretation : чечмелөө : толкование
interpreter : котормочу : переводчик
interrogative : суроолуу : вопросительный
interval : интервал : антракт, промежуток
into : ичине : в
introduce : тааныштыруу : представлять, знакомить
invalid : жараксыз : недействительный
invitation : чакыруу : приглашение
invitations : чакыруулар : приглашения
invite : чакыруу : приглашать
invited : чакырылган : пригласил, приглашенный
iron : темир : железо, утюг
irritation : кыжырдануу : раздражение
is : болуп саналат : есть (от be)
isn’t : эмес : is not
issue : чыгаруу : выпуск, издание
it : ал : это, он, она
it beats me : бул мени урат : я не понимаю
it’s : бул : it is
item : пункт : вещь, предмет
its : анын : его, ее
jacket : куртка : куртка
jam : джем : варенье, джем
January : Январь : январь
jazz : джаз : джаз
jeans : джинсы : джинсы
jewellery : зер буюмдар : ювелирные изделия
job : жумуш : работа
jobs : жумуштар : работы
jogging : чуркоо : бег
joint : биргелешкен : совместный, объединенный
joking : тамаша : шутка, шутящий
jolly : кубанычтуу : очень, веселый
journalist : журналист : журналист
journey : саякат : путешествие
joy : кубаныч : радость
juice : ширеси : сок
July : Июль : июль
jump : секирүү : прыгать
jumped : секирди : прыгал (а)
jumper : секирүүчү : джемпер
June : Июнь : июнь
just : жөн гана : только, всего лишь
keen : дилгир : страстный
keep : сактоо : (со)держать, сохранять
keeping : сактоо : хранение, содержание
keepsake : эстелик : подарок
kept : сакталган : заставил
key : ачкыч : ключ
kick up : тепкиле : поднимать (шум)
kicked up : тепти : поднял
kid : бала : ребенок, детка
kidding : тамаша : шутящий
kidney : бөйрөк : почка
kids : балдар : дети
kill : өлтүрүү : убивать
killed : өлтүрүлгөн : убил
kilogram : килограмм : килограмм
kilometre : километр : километр
kind : боорукер : добрый, вид, род
knee : тизе : колено
knew : билген : знал
knife : бычак : нож
knitted : токулган : вязанный, трикотажный
knocked down : кулады : растерялся
knocked down with a feather : мамык менен жыгылды : ошеломил
know : билем : знать
knowing : билүү : знание, знающий
ladies : айымдар : дамы
ladies’ : айымдар : женский туалет
lady : айым : дама, госпожа
laid : коюлган : происходил, совершался
lamb : козу : ягненок, баранина
land : жер : земля, приземляться
language : тил : язык
lark : ларк : шутка, забава
last : акыркы : прошлый, последний
late : кеч : поздно
later : кийинчерээк : позже
latest : акыркы : последний
laugh : күлүү : смех, смеяться
laughed : күлдү : смеялся, хохотал
laughing : күлүп : смех, смеющийся
laughter : күлкү : смех, хохот
laundry : кир жуучу : прачечная, стирка
lazy : жалкоо : ленивый
leader : лидер : глава, лидер
leap : секирүү : високосный, прыжок
learn : үйрөн : узнать, учиться
learnt : окуган : узнал, выученный
leather : тери : кожа, кожаный
leave : кет : оставлять, покидать
leaving : кетүү : уезжающий
left : сол : покинутый, оставленный
left : сол : левый, налево
left luggage office : жүк ташуучу кеңсеси калды : камера хранения
leg : бут : нога
leisure : эс алуу : досуг
lemon : лимон : лимон
lend : карыз берүү : дать а долг
length : узундугу : длина
lent : карыз берген : одолжил, дал в долг
less : азыраак : менее, в меньшей степени
lesson : сабак : урок
let : болсун : позволять, давать
let’s : келгиле : давайте
letter : кат : письмо
letters : тамгалар : письма
lettuce : салат : салат
licence : лицензия : лицензия, разрешение
life : жашоо : жизнь
lifeboat : куткаруучу кайык : спасательная лодка
lift : көтөрүү : поднимать, подъемник
lifts : көтөрөт : лифты
light : жарык : свет, освещение
light : жарык : светлый, легкий
lighter : жеңилирээк : зажигалка
lights : жарыктар : фары
like : сыяктуу : любить, нравиться
liked : жакты : нравился, любил
likely : мүмкүн : вероятно
limit : чектөө : предел, граница
line : линия : линия, специальность
linen : зыгыр буласынан : белье
liner : лайнер : лайнер
lip : эрин : губа
lip-stick : помада : помада
liquid : суюк : жидкость
liquor : ичимдик : крепкий напиток
list : тизме : список
listen : ук : слушать
listened : укту : слушал
literature : адабият : литература
litre : литр : литр
litter : таштанды : мусор, сорить
little : аз : мало, маленький
live : жашоо : жить
lived : жашаган : жил, живший
liver : боор : печень
living : жашоо : жизнь
locked : кулпуланган : запертый
long : узун : длинный, долгий
longer : узунураак : длиннее
look : кара : смотреть, выглядеть
look for : издөө : искать
look sharp : курч карап : глядите в оба
looked for : издөө : искал
looking : карап : смотрящий
looks : көрүнөт : выглядит
lose : жоготуу : терять, проигрывать
lost : жоголду : потерял, проиграл
lost her temper : ачуусун жоготту : вышла из себя
lot : көп : много
louder : катуураак : громче
love : сүйүү : любовь, любить
loved : сүйгөн : любил
lovely : сүйкүмдүү : прекрасный, восхитительный
lover : сүйгөн : любитель, возлюбленный
lower : төмөн : нижний, снижать
luck : ийгилик : удача, везение
lucky : бактылуу : счастливый, удачный
luggage : багаж : багаж
lunch : түшкү тамак : второй завтрак, обед
luxurious : люкс : роскошный
mad : жинди : обезумевший
made : жасалган : делал, сделанный
made catcalls : коңгуроолорду жасаган : освистали
made reservations : эскертүүлөрдү жасашкан : забронирован
magazine : журнал : журнал
magazines : журналдар : журналы
maid : күң : горничная
mail : почта : почта, отправлять
main : негизги : главный
major : майор : специализироваться
make : жасоо : делать, производить
make reservations : ээлеп коюу : забронировать
make-up : түзүү : косметика
makes : түзөт : делает
man : адам : мужчина, человек
manage : башкаруу : справляться, управлять
management : башкаруу : управление
manager : менеджер : управляющий
manages : башкарат : ухитряется
many : көп : много
many happy returns : көптөгөн бактылуу кайтып келет : всего наилучшего
map : карта : карта
March : Март : март
mark : белгилөө : состояние, оценка
market : базар : рынок
marks : белгилер : оценки
marriage : үйлөнүү : свадьба
married : үйлөнгөн : женатый, замужняя
mascara : тушь : тушь
massage : массаж : массаж
masterpiece : шедевр : шедевр
match : дал келүү : спичка, матч
math : математика : математика
matinees : эртеңкилер : утренние спектакли
matter : маселе : дело, сущность, материал
matters : маанилүү : дела, материалы
May : Май : май
may : Май : могу, может
maybe : болушу мүмкүн : может быть
mayonnaise : майонез : майонез
mayor : мэр : мэр
me : мага : мне, меня
meal : тамак : еда, принимать пищу
meals : тамактар : еда
mean : дегенди билдирет : означать
means : билдирет : средство, способ
measuring : өлчөө : измерения
meat : эт : мясо
mechanic : механик : механик
medal : медаль : медаль
medical : медициналык : медицинский
medicine : дары : медицина, лекарство
meet : жолугушуу : встречать (ся), знакомиться
meeting : жолугушуу : встреча
melon : коон : дыня
member : мүчөсү : член
members : мүчөлөрү : члены
men : эркектер : мужчины
men’s : эркектердики : мужские
mend : оңдоо : чинить, ремонтировать
mended : оңдогон : починил, починенный
mention : эскерүү : благодарность, упоминать
mentioned : айтылган : упомянул
menu : меню : меню
merry : көңүлдүү : веселый, радостный
mess : баш аламандык : беспорядок, путаница
message : билдирүү : сообщение, поручение
met : жолугушту : встречались, встреченный
metal : металл : металл, металлический
meter : метр : счетчик
metered : өлчөнгөн : платный
metre : метр : метр
middle : орто : средний
middling : ортолук : средний, сносный
midnight : түн жарымы : полночь
might : мүмкүн : можно, возможно
mild : жумшак : мягкий
mile : миль : миля
mileage : пробег : пробег
miles : миль : мили
millilitre : миллилитр : миллилитр
million : миллион : миллион
mince : майдалоо : смягчать, в мягкой форме
mind : акыл : память, мнение
mine : меники : мой
mineral : минерал : минеральный
minute : мүнөт : минута
minutes : мүнөт : минуты
miracle : керемет : чудо
miracles : кереметтер : чудеса
miss : мисс : промах, промахнуться
miss : мисс : мисс, госпожа
mistake : ката : ошибка
mistaken : жаңылыштык : ошибочный
mister (Mr) : мырза (мырза) : мистер, господин
mistress (Mrs) : мырзайым (айым) : миссис, госпожа
mistrust : ишенбөөчүлүк : недоверие, подозрение
mixer : аралаштыргыч : смеситель, миксер
mixture : аралашма : микстура
modern : заманбап : современный
moment : учур : момент, миг
Monday : Дүйшөмбү : понедельник
money : акча : деньги
money order : акча которуу : почтовый перевод
month : ай : месяц
monthly : ай сайын : (еже)месячный, ежемесячно
months : айлар : месяцы
monument : эстелик : памятник
monuments : эстеликтер : памятники
moon : ай : луна
moot : талаш : спорный
more : көбүрөөк : еще, больше
morning : эртең менен : утро
Moscow : Москва : Москва
most : көбү : самый, весьма
motel : мотел : мотель, гостиница
mother : эне : мама
mountain climbing : тоого чыгуу : альпинизм
mouth : ооз : рот
move : жылдыруу : двигать (ся), переезжать
movie : кино : кино, фильм
movies : тасмалар : кино, фильмы
much : көп : много
museum : музей : музей
mushroom : козу карын : гриб
mushrooms : козу карындар : грибы
music : музыка : музыка
musical : музыкалык : музыкальный, мюзикл
must : керек : должен, надо
must be x-rayed : рентгенге тартылышы керек : надо сделать рентген
mustard : горчица : горчица
mustn’t : болбошу керек : нельзя
my : менин : мой, моя, мое, мои
myself : өзүм : себя, меня самого
nail : мык : ноготь, гвоздь
nails : мыктар : ногти
name : аты : имя, фамилия
nasty : жаман : скверный, плохой
national : улуттук : национальный
nationality : улуту : национальность
near : жакын : близко от, около
nearby : жакын : поблизости
nearest : эң жакын : ближайший
necessary : зарыл : нужный, необходимый
necklace : мончок : ожерелье
need : керек : нуждаться в, надо
needn’t : кереги жок : не нуждаться в, не надо
nerves : нервдер : нервы
never : эч качан : никогда
new : жаңы : новый
news : жаңылыктар : новости, известия
news-stand : жаңылыктар стенди : газетный киоск
newspaper : газета : газета
newspapers : газеталар : газеты
next : кийинки : следующий, соседний
nice : жакшы : хороший, чудесный
nice kettle of fish : жакшы чайнек балык : хорошенькое дело
nicer : жакшыраак : лучше
nicest : эң сонун : самый вкусный
nickel : никель : никл (монета в  центов)
night : түн : ночь
nights : түндөр : ночи
nine : тогуз : девять
nineteen : он тогуз : девятнадцать
ninety : токсон : девяносто
ninth : тогузунчу : девятый
no : жок : нет, никакой
nobody : эч ким : никто
non : жок : не
non-smoker : тамеки тартпаган : вагон для некурящих
non-stop : тынымсыз : беспосадочный
none : эч ким : нисколько, совсем не, вовсе не
nonsense : болбогон сөз : чепуха, ерунда
nonsmoking : тамеки тартпаган : некурящий
noodle : кесме : лапша
north : түндүк : север
nose : мурун : нос
not : жок : не
note : Эскертүү : запись, банкнота
nothing : эч нерсе : ничто, ничего
notify : кабарлоо : сообщить
novel : роман : роман
novels : романдар : романы
November : Ноябрь : ноябрь
now : азыр : сейчас
nuisance : түйшүк : досада
number : саны : номер
numeral : сан : числительное, цифра
numerals : сандар : числительные
nursery : бала бакча : детский, ясли
nut : гайка : орех
nuts : гайкалар : орехи
nylon : нейлон : нейлон, нейлоновый
o’clock : саат : часов
object : объект : возражать, предмет
objection : каршы чыгуу : возражение, протест
objections : каршылыктар : возражения
oblige : милдеттендирүү : обязывать
obliged : милдеттүү : обязан, признателен
occupation : басып алуу : занятие
October : Октябрь : октябрь
odd : кызык : странный
of : нын : предлог родительного падежа
of course : Албетте : конечно
off : өчүрүү : прочь, от
offer : сунуш : предлагать
office : кеңсе : офис, контора
officer : офицер : служащий, офицер
official : расмий : официальный, чиновник
officials : кызмат адамдары : чиновники
often : көп учурда : часто
Oh : О : O!
oil : май : масло
ointment : май : мазь
OK : макул : о‘кей, все в порядке
old : эски : старый
old-fashioned : эскиче : старомодный
oldest : эң эски : старший, самый старый
omelette : омлет : омлет
on : күйүк : на, вперед, дальше
on behalf of : атынан : от имени
one : бир : один, некто
onion : пияз : лук
only : гана : только, единственный
open : ачык : открывать
opened : ачылды : открыл, открытый
opening : ачуу : начало, открытие
opera : опера : опера
opera glasses : опера көз айнеги : театральный бинокль
opinion : пикир : мнение
option : параметр : выбор
or : же : или
orange : ачык күрөң : апельсин, оранжевый
oranges : апельсин : апельсины
orchestra : оркестр : партер, оркестр
order : тартип : порядок, приказ
ordered : буйрук берди : приказал
ordinal : тартиби : порядковый
organization : уюштуруу : организация
organizations : уюмдар : организации
organize : уюштуруу : организовывать
organized : уюштурулган : организовывал
original : оригиналдуу : оригинал, первоначальный
other : башка : другой
ounce : Унция : унция
our : биздин : наш
ourselves : өзүбүзгө : себя, себе, сами
out : чыгып : вне, вон, из
outdoor : сыртта : на открытом воздухе
outlet : розетка : выход, выходное отверстие
over : бүттү : через, сверх
overcharged : ашыкча төлөм : взятые сверх
overdrawn : ашыкча тартылды : преувеличенный, превышенный
overdue : мөөнөтү өтүп кеткен : запоздалый
overjoyed : кубанычтуу : очень довольный
overtime : убакыттын өтүшү менен : сверхурочный
owe : карыз : быть должным
own : менчик : иметь, владеть
oyster : устрица : устрица
oysters : устрицалар : устрицы
package : пакет : пакет
paid : төлөнгөн : платил, оплаченный
pain : оору : боль, страдание
pains : ооруйт : боли, страдания
paint : боёо : красить, краска
painter : сүрөтчү : художник
painting : сүрөт : живопись
panty hose : труси шланг : колготки
parcel : посылка : пакет
pardon : кечир : извинение
parent : ата-эне : родитель
parents : ата-энелер : родители
park : парк : парк, (при)парковать (ся)
parking : паркинг : стоянка
parlour : бөлмө : кабинет
parrot : тоту куш : попугай
part : бөлүгү : часть, доля, роль
part-time : жарым күндүк : неполный рабочий день
parties : партиялар : вечеринки
parting : ажырашуу : прощание
parts : бөлүктөр : части
party : кече : вечеринка, группа
pass : өтүү : передавать, проходить
passage : өтүү : проход
passed : өттү : прошел
passport : паспорт : паспорт
past : өткөн : после, за
pate : пате : паштет
pay : төлөө : платить, зарплата
payment : төлөм : плата
peace : тынчтык : мир
peach : шабдалы : персик
peaches : шабдалы : персики
pear : алмурут : груша
pearl : бермет : жемчуг, жемчужный
pears : алмурут : груши
peas : буурчак : горошек, горох
pen : калем : ручка
pence : пенс : пенс
penny : пенни : пенни
pension : пенсия : пенсия
pensioner : пенсионер : пенсионер
people : адамдар : люди
per : ичинде : в
percent : пайыз : процент
perfectly : кемчиликсиз : совершенно, вполне
perfectly well : абдан жакшы : отлично
perform : аткаруу : делать, выполнять
performance : аткаруу : спектакль
perfume : атыр : духи
perfumery : парфюмерия : парфюмерия
perhaps : балким : возможно, может быть
permanent : туруктуу : постоянный
permission : уруксат : разрешение
permit : уруксат : разрешать
pet : үй жаныбары : любимое животное, любимец
petrol : бензин : бензин
pets : үй жаныбарлары : домашние животные
phone : телефон : телефон
photographing : сүрөткө тартуу : фотографирование
photography : сүрөт тартуу : фотография
physics : физика : физика
piano : пианино : пианино
pick : тандоо : собирать, подбирать
pickles : туздалган бадыраң : маринованные огурцы
picture : сүрөт : картина, изображение
pictures : сүрөттөр : картины
pie : пирог : пирог
piece : даана : кусок
pill : таблетка : таблетка, пилюля
pillow : жаздык : подушка
pills : таблеткалар : таблетки
pin : пин : булавка, значок
pineapple : ананас : ананас
pink : кызгылт : розовый
pins : пиндер : значки
pint : пинт : пинта
piping hot : ысык түтүк : очень горячий
pity : аяш : жалость
pizza : пицца : пицца
place : жер : место
plain : жөнөкөй : ясный, очевидный
plain as a pikestaff : тактай эле : очевидный, ясный
plan : план : план, планировать
plane : учак : самолет
planes : учактар : самолеты
plans : пландар : планы
plate : табак : тарелка
plates : плиталар : тарелки
platform : платформа : платформа
play : ойноо : играть, игра
played : ойноду : играл
player : оюнчу : плеер, игрок
playing : ойноп жатат : играющий
plays : ойнойт : играет
pleasant : жагымдуу : приятный
please : өтүнөмүн : пожалуйста
pleasure : ырахат : удовольствие
plum : кара өрүк : слива
plums : кара өрүк : сливы
pocket-knife : чөнтөк бычак : перочинный нож
poem : поэма : стихотворение, поэма
poems : ырлар : стихи
point : пункт : точка, пункт
point-blank : чексиз : резко, наотрез
policeman : полициячы : полицейский
polish : Полякча : лак
polite : сылык : любезный, вежливый
politics : саясат : политика
pollution : булгануу : загрязнение
pool : бассейн : пруд, бассейн
poor : кедей : бедный
poorly : начар : плохо, неважно
pop : поп : поп, популярный
popular : популярдуу : популярный
pork : чочконун эти : свинина
porridge : ботко : каша
port : порт : порт
portable : көчмө : переносной
porter : портер : носильщик
ports : порттор : порты
possible : мүмкүн : возможный
possibly : мүмкүн : возможно
post : пост : почта, после
post-office : почта : почта
postcard : открытка : почтовая открытка
potato : картошка : картофель
potatoes : картошка : картофель
pound : фунт : фунт, фунт стерлингов
pounds : фунт : фунты
powder : порошок : пудра
practice : практика : практика
practiced : машыккан : применял, практиковал
praise : мактоо : хвалить
praised : мактаган : хвалил
prefer : артык : предпочитать
preferred : артыкчылыктуу : предпочитал
prepare : даярдоо : готовить (ся)
prepared : даярдалган : готовился, готовый
prerecorded : алдын ала жазылган : предварительно записанный
prescription : рецепт : рецепт
presence : болушу : присутствие
present : азыркы : настоящее время, подарок
present : азыркы : дарить
presents : белек кылат : подарки
press : басыңыз : (по)гладить, сжимать
pressed : басылган : поглаженный, сжатый
pressure : басым : давление
pretty : сулуу : хороший, значительный
preview : алдын ала көрүү : предварительный просмотр
price : баасы : цена
primitive : примитивдүү : примитивный
printed matter : басма буюм : печатный материал, бандероли
private : жеке : частный
probability : ыктымалдуулук : вероятность
probable : мүмкүн : вероятный
probably : балким : вероятно
problem : көйгөй : проблема
problems : көйгөйлөр : проблемы
produce : өндүрүү : производить
produced : өндүрүлгөн : производил
profession : кесип : профессия
program : программасы : программа
programmes : программалар : программы, передачи
programs : программалар : программы
prohibit : тыюу салуу : запрещать
prohibited : тыюу салынган : запрещенный
prohibition : тыюу салуу : запрет
project : долбоор : проект
projects : долбоорлор : проекты
promise : убада : обещать
promised : убада кылган : обещал
promising : келечектүү : многообещающий
pronouns : ат атоочтор : местоимения
property : мүлк : собственность, имущество
proposal : сунуш : предложение
proposals : сунуштар : предложения
propose : сунуш кылуу : предлагать
pros : прос : за
provide : камсыз кылуу : обеспечивать
publish : жарыялоо : публиковать
published : жарыяланган : публиковал, опубликованный
publishing : басып чыгаруу : публикующий, издание
pull : тартуу : тянуть, тащить
pullover : токтотуу : пуловер
pulled off : тартып алды : добился, справился
puppet show : куурчак театры : кукольный театр
purpose : максаты : цель
push : түртүү : толкать
put : коюу : класть, размещать
puzzle : табышмак : загадка
puzzled : таң калды : озадачен, поставлен в тупик
quality : сапаты : качество
quarter : квартал : четверть, квартал
question : суроо : вопрос
questions : суроолор : вопросы
quick : тез : быстрый
quicker : тезирээк : быстрее
quit : таштоо : прекращать
quite : абдан : вполне, совсем
rack : стойка : полка для багажа
racket : ракетка : ракетка
radio : радио : радио
rage : ачуулануу : гнев, ярость
rain : жамгыр : дождь
rain-coat : жамгыр пальто : плащ
raising : көтөрүү : воспитание
ran : чуркады : бежал, убежавший
rare : сейрек : редкий, недожаренный
rate : чен : тариф, расценка
rates : тарифтер : стоит
rather : тескерисинче : скорее, лучше
razor : устара : бритва
reaction : реакция : реакция
read : окуу : читать
reading : окуу : чтение
ready : даяр : готовый
ready-made : даяр : готовый
realistic : реалдуу : реалистический
really : чын эле : действительно
rear : арткы : задняя часть
recall : чакырып алуу : припомнить, отозвать
receipt : квитанция : квитанция
reception : кабыл алуу : прием
recommend : сунуштайбыз : рекомендовать
record : рекорд : запись, пластинка
recorder : жазгыч : записывающее устройство
records : жазуулар : пластинки
recover : калыбына келтирүү : выздоравливать
recovery : калыбына келтирүү : выздоровление
red : кызыл : красный
reduce : азайтуу : уменьшать, сокращать
reducing : азайтуу : понижение
reference : шилтеме : рекомендация, ссылка, справка
references : шилтемелер : рекомендации
refreshments : сергитүү : закуски и напитки
refrigerator : муздаткыч : холодильник
refuse : баш тартуу : отказывать
refused : баш тартты : отказался
regards : урматтоо менен : привет, поклон
register : катталуу : (за)регистрировать
registered : катталган : зарегистрированный, заказной
registration : каттоо : регистрация
relation : мамиле : отношение, связь
relations : мамилелер : отношения, связи
relationship : мамиле : родственные связи
rely : таянуу : полагаться, доверять
remember : эсте : помнить
remembered : эстеди : помнил
remote : алыскы : дистанционный, удаленный
rent : ижарага алуу : снимать жилье
renting : ижарага алуу : аренда, снятие комнаты
repair : оңдоо : ремонтировать, ремонт
repaired : ремонттолгон : ремонтировал
representative : өкүлү : представитель
representatives : өкүлдөрү : представители
request : өтүнүч : просьба
requests : өтүнүчтөр : просьбы
research : изилдөө : исследовать
reservation : резервация : резервирование
reservations : резервациялар : предварительные заказы
reserve : резерв : заказывать
reserved : сакталган : заказал, заказанный
resident : тургуну : постоянный житель
respect : урматтоо : уважение, уважать
rest : эс алуу : отдых, отдыхать
restaurant : ресторан : ресторан
rested : эс алды : отдыхал
restriction : чектөө : ограничение
restrictions : чектөөлөр : ограничения
restroom : даараткана : туалет
restrooms : дааратканалар : туалеты
return : кайтуу : вернуть (ся), возвращение
ride : минүү : езда, прогулка
riding : минүү : езда
right : туура : правильный, правый
ring : шакек : кольцо, звон
river : дарыя : река
river-port : дарыя порту : речной порт
road : жол : дорога
roar : күркүрөө : реветь, орать
roast : куурулган : жареный
robbery : тоноо : грабеж
role : ролу : роль
roll : түрмөк : вращение, список
roller : ролик : ролик
roller skating : ролик тебүү : катание на роликах
room : бөлмө : комната
roomette : бөлмө бөлмөсү : спальное купе
rooms : бөлмөлөр : комнаты
root for : үчүн тамыр : “болеть”
rot : чиритүү : вздор, нелепость
rotten luck : чириген ийгилик : незадача
round : тегерек : круг, цикл
route : маршрут : маршрут, путь
rowing : кайык : гребля, выговор
rubbish : таштанды : ерунда, мусор
rude : орой : грубый, резкий
rule : эреже : правило, принцип
rules : эрежелер : правила
rump-steak : стейк : ромштекс
run : чуркоо : бегать, двигаться
running nose : аккан мурун : насморк
running out of : түгөндү : кончающийся, иссякающий
rush for : үчүн шашыл : большой спрос на
Russia : Орусия : Россия
Russian : Орусча : русский
sad : кайгылуу : печальный
safe : коопсуз : сейф, безопасный
said : деди : сказал
sail : сүзүү : парус, плыть
sailor : матрос : матрос
sake : үчүн : ради, для
salad : салат : салат, винегрет
sale : сатуу : распродажа
salmon : лосось : лосось
salt : туз : соль, соленый
same : бирдей : тот же, так(ой) же
sandwich : сэндвич : бутерброд
sang : ырдаган : пел, спел
sat : отурду : сидел
satellite : спутник : спутник
Saturday : Ишемби : суббота
sauce : соус : соус, приправа
sausage : колбаса : колбаса, сосиска
save : сактоо : спасать, хранить
saved : сакталган : спасал
savings account : аманат эсеби : счет
saw : көрдү : видел, смотрел
say : айт : сказать, говорить
saying : деп : говорящий
scarf : жоолук : шарф
scene : көрүнүш : действие, картина
scenes : көрүнүштөр : сцены, эпизоды
schedule : расписание : расписание, таблица
scholarship : стипендия : стипендия, ученость
school : мектеп : школа, обучать
science : илим : наука, умение
sciences : илимдер : науки
scientific : илимий : научный
score : упай : счет, отметка
scream : кыйкыруу : вскрикнуть, зареветь
screen : экран : экран, перегородка
sea : деңиз : море, океан
sea port : деңиз порту : морской порт
sea-sick : деңиз оорулуу : страдающий морской болезнью
seaside : деңиз жээги : морское побережье
season : сезон : время года, сезон
seat : отургуч : место, сиденье
seats : орундар : места
second : экинчи : второй, секунда
second class : экинчи класс : второклассный
second hand : экинчи колу : комиссионный
secondary : орто : средний, второстепенный
section : бөлүм : отделение, делить на части
see : көрүү : (у)видеть, встретиться
seeing : көрүү : видящий
seem : көрүнөт : казаться
seen : көргөн : увиденный
seldom : сейрек : редко
select : тандоо : выбирать, сортировать
sell : сатуу : продавать, торговать
send : жөнөтүү : отправлять, посылать
sent : жиберилди : отправил, послал
September : Сентябрь : сентябрь
serve : кызмат кылуу : служить, обслуживать
service : кызмат : сервис, обслуживание
set : коюу : класть, ставить
sets : топтомдору : декорации
settle : чечүү : поселять, устраивать
seven : жети : семь
seventeen : он жети : семнадцать
seventh : жетинчи : седьмой
seventy : жетимиш : семьдесят
several : бир нече : несколько
sex : секс : пол
shade : көлөкө : оттенок, тень, затенять
shades : көлөкөлөр : оттенки
shadow : көлөкө : тень, покров
shake : чайка : пожать (руки), дрожать
shall : болот : модальный глагол
shame : уят : стыд, стыдить
shampoo : шампунь : шампунь
shape : форма : состояние, положение
shaping : калыптандыруу : шейпинг
share : бөлүшүү : разделять, доля
sharp : курч : ровно, резкий
shave : кыруу : (по)бриться, бритье
shaver : устара : бритва
shaving : кыруу : бритье
she : ал : она
shindy : жалтырак : шум, скандал
ship : кеме : корабль, пароход
shirt : көйнөк : рубашка, блуза
shoe : бут кийим : ботинок, туфля
shoes : бут кийим : обувь, туфли
shop : дүкөн : магазин, мастерская
shopping : соода : делать покупки
shops : дүкөндөр : магазины
short : кыска : короткий, слабый
shorter : кыскараак : короче
shortest : эң кыска : ближайший, самый короткий
shot : атып : попытка, выстрел
should : керек : модальный глагол
shoulder : ийин : плечо, толкать
shouldn’t : болбошу керек : не следует
show : көрсөтүү : показывать, демонстрировать
showed : көрсөттү : показал
shower : душ : душ, ливень
shrimp : чабак : креветка
shut : жап : закрывать, запирать
sick : оорулуу : больной
sight : көрүү : зрелище, вид
sights : кооз жерлер : достопримечательности
sign : белги : подписывать (ся), знак
signature : кол коюу : подпись
signs : белгилер : знаки, вывески
silk : жибек : шелковый, шелк
silly : акылсыз : глупый
silver : күмүш : серебро, серебряный
simple : жөнөкөй : простой, однозначный
simply : жөн гана : просто, абсолютно
sing : ырда : пение, петь
singer : ырчы : певец
single : бойдок : один, одинокий
sir : сэр : сэр
sister : эже, карындаш, сиңди : сестра
sit : отур : сидеть, заседать
situation : кырдаал : местность, должность
six : алты : шесть
sixpence : алты пенс : сумма в  пенсов
sixteen : он алты : шестнадцать
sixth : алтынчы : шестой
sixty : алтымыш : шестьдесят
size : өлчөмү : размер, величина
skate : коньки тебүү : кататься на коньках
skateboarding : скейтбординг : катание на роликовой доске
skating : коньки тебүү : катание, катающийся
skating-rink : муз тебүүчү аянтча : каток
ski : лыжа тебүү : ходить на лыжах
skiing : лыжа тебүү : катание на лыжах
skilled : чебер : квалифицированный, умелый
skin diving : териге секирүү : подводное плавание
skirt : юбка : юбка
slack : боштук : ленивый, слабый
sleep : уктоо : спать, сон
sleeper : уктоочу : спальный вагон
slept : уктап калды : спал
slightest : кичине : малейший
slow : жай : медленный, замедлять
slower : жайыраак : медленнее
slumber : уйку : сон, дремота, дремать
small : кичинекей : маленький, тонкий
smoke : түтүн : курить, дым
smoked : ышталган : курил
smoker : тамеки тартуучу : курящий
smokers : тамеки чеккендер : курящие
smoking : тамеки тартуу : курение
snack : закуска : закуска, часть
so : ошондой : так, таким образом
so-so : эптеп-септеп : так себе
soap : самын : мыло
society : коом : общество
sock : байпак : носок
socks : байпак : носки
softly : жумшак : осторожно
sold : сатылды : продавал, проданный
some : кээ бир : немного, несколько
something : бир нерсе : что-то
somewhere : бир жерде : куда-нибудь
son : уул : сын
sons : уулдары : сыновья
soon : жакында : скоро, рано
sooner : эртерээк : охотнее
sore : оору : больной, воспаленный
sorry : кечириңиз : сожалеющий, печальный
sort : сорттоо : сорт, род
soul : жан : душа, воплощение
sound : үн : звук, звучать
sounding : угулууда : звучащий
sounds : үндөр : звучит
soup : шорпо : суп
south : түштүк : юг, южный
souvenir : сувенир : сувенир
souvenirs : сувенирлер : сувениры
spare : запас : уделять, лишний
speak : сүйлө : говорить, убеждать
speaking : сүйлөп жатат : говоря(щий)
specialist : адис : специалист
speciality : өзгөчөлүк : фирменное блюдо
speed : ылдамдык : скорость, ускорять
speedy : тез : быстрый, скорый
spend : сарптоо : проводить (время)
spends : сарптайт : проводит
spent : сарпталган : проводил, тратил
splendid : сонун : замечательно
spoke : сүйлөдү : говорил, говоривший
spoon : кашык : ложка
spoons : кашыктар : ложки
sport : спорт : спорт, заниматься спортом
sporting : спорттук : спортивный
sports : спорт : спорт
sportsfan : спорт фанаты : болельщик
sportsman : спортчу : спортсмен
sprang a surprise : сюрприз кылды : сделал сюрприз
spring : жаз : весна
spring a surprise : сюрприз жаз : делать сюрприз
spring upon : жаз : открыть, сообщить
sprung upon : пайда болгон : застал (а) врасплох
square : чарчы : площадь, квадратный
stadium : стадион : стадион
stage : этап : сцена, эстрада
stall : станок : партер
stalls : күркөлөр : кресла в партере
stamp : штамп : марка, печать
stamps : штамптар : марки
stand : туруу : остановка, позиция
star : жылдыз : звезда, судьба, рок
start : баштоо : начинать, отправляться
starter : стартер : стартер
station : станция : станция, место, размещать
stay : кал : оставаться, жить
stayed : калды : остался
staying : калуу : остающийся, живущий
step : кадам : шаг, шагать
stereo : стерео : стерео
stewardess : стюардесса : стюардесса
stick : таяк : палка, приставать
stick it out : аны чыгар : не поддавайся
stocking : байпак : чулок
stockings : байпак : чулки
stolen : уурдалган : украденный
stomach : ашказан : живот, желудок
stomach-ache : ашказан оорушу : боль в желудке
stop : токто : остановка, перестать
stopped : токтоду : остановились
stops : токтойт : остановки
store : дүкөн : магазин, имущество
storey : кабаттуу : этаж
stories : окуялар : истории, рассказы
story : окуя : рассказ, история
stove : меш : печь, плита
straight : түз : прямо, сразу
stranger : бейтааныш : незнакомец, иностранец
straw : саман : пустяк, мелочь
strawberries : кулпунай : клубника
street : көчө : улица
strength : күч : численность, сила, прочность
striking : уруучу : бьющий, ударяющий
string : сап : вереница, ряд
stroke : инсульт : удар, гладить
stroke of luck : ийгилик соккусу : удача
stroll : сейилдөө : прогулка, гулять
student : студент : студент
students : студенттер : студенты
studied : окуган : учился
study : окуу : учиться, изучать
studying : окуп жатат : изучение
style : стили : стиль, фасон
subject : тема : предмет, содержание
subjects : предметтер : предметы
subscription : жазылуу : подписка
suburb : чет жака : пригород, окраина
suburbs : шаар четтери : окрестности
success : ийгилик : успех, удача
successes : ийгиликтер : успехи
such : ушундай : такой
suggest : сунуш кылуу : предлагать, советовать
suggested : сунуш кылды : предлагал, предложенный
suggestion : сунуш : предложение
suggestions : сунуштар : предложения
suit : костюм : костюм, подходить
suitable : ылайыктуу : подходящий, соответствующий
suitcase : чемодан : чемодан
suitcases : чемодандар : чемоданы
suite : люкс : номер люкс
sum : сом : сумма, подводить итог
summer : жай : лето, летний
sun : күн : солнце
sunbathe : күнгө күйүү : загорать
Sunday : Жекшемби : воскресенье
sunny : күн ачык : солнечный
superb : сонун : превосходный
supermarket : супермаркет : супермаркет
supper : кечки тамак : ужин
suppose : дейли : полагать, предполагать
supposed : болжолдонгон : предполагаемый
sure : албетте : уверенный, убедиться
surprise : сюрприз : удивление, удивлять
swallow : жутуу : глотать, проглатывать
swam : сүздү : плавал
sweater : свитер : свитер
sweet : таттуу : милый, сладкий
swell : шишип : отличный, превосходный
swelling : шишик : воспаление, отек
swim : сүзүү : плавать
swimming : сүзүү : плавание
swimming-pool : бассейн : бассейн
switch : которуу : переключать, включать
sympathise : боор ооруу : сочувствовать
sympathy : симпатия : симпатия, сострадание
synthetic : синтетикалык : синтетический
system : системасы : система
table : стол : стол, таблица, расписание
tablet : планшет : таблетка
tablets : таблеткалар : таблетки
tack : так : линия, курс
tacks : тактар : линии
tag : тег : бирка, ярлык
tail : куйрук : конец, хвост
take : алуу : брать, взять, принимать
take a crack at : бир жарака алуу : попытаться в
take in : алуу : обмануть
take it for granted : аны кадимкидей кабыл алуу : считать само собой разумеющимся
take place : орун алуу : случаться, состояться
taken in : алынган : обманутый
take place : орун алуу : состояться
tale : жомок : повесть, сказка, история
tales : жомоктор : сказки, истории
talk : сүйлөш : говорить, беседовать
talking : сүйлөшүү : беседа
tall : узун : невероятный, высокий
tall story : узун окуя : небылица
tape : лента : лента, обматывать лентой
taste : даам : пробовать, иметь вкус
tasted : даамын татты : пробовал
tastes : даамдары : имеет вкус
taught : үйрөткөн : обучал, обученный
taxi : такси : такси
tea : чай : чай, отвар
teach : үйрөтүү : обучать, преподавать
teacher : мугалим : учитель
team : команда : команда
teams : командалар : команды
technical : техникалык : технический
teenager : өспүрүм : подросток
teenagers : өспүрүмдөр : подростки
telegram : телеграмма : телеграмма
telephone : телефон : телефон, звонить
television : телевидение : телевидение
tell : айт : говорить, рассказывать
temper : мүнөз : сдержанность, самообладание
temperature : температура : температура
ten : он : десять
tennis : теннис : теннис
tenth : онунчу : десятый
terminal : терминал : конечный пункт
terms : шарттары : личные отношения
terrible : коркунучтуу : ужасный, страшный
terribly : коркунучтуу : ужасно
terrific : укмуш : потрясающий, ужасающий
test : сыноо : проверка, испытывать
textiles : текстиль : ткани
than : караганда : чем
thank : рахмат : благодарить
thanks : рахмат : спасибо
that : ошол : это, тот, та, то
that’ll : ошол болот : это будет
that’s : ошол : это есть
the : белгилүү артикль : определенный артикль
the last straw : акыркы тамчы : последняя капля
theatre : театр : театр
theatres : театрлар : театры
their : алардын : их (на вопрос “чей?”)
them : алар : их (на вопрос “кого?”)
there : ошол жерде : там, туда, вот
there’s : бар : есть, имеется
these : булар : эти, это
they : алар : они
thick : коюу : толстый, густой
thing : нерсе : вещь, предмет
things : нерселер : вещи, дела
think : ойлон : думать, мыслить
thinks : ойлойт : думает
third : үчүнчү : третий
thirsty : суусаган : испытывающий жажду
thirteen : он үч : тринадцать
thirty : отуз : тридцать
this : бул : этот, это
those : ошол : тот, та, то, те
thought : ойлоду : думал, мысль
thousand : миң : тысяча
thrash out : чаап чыгуу : выяснять
three : үч : три
thrice : үч жолу : трижды
thrilling : толкундатуучу : захватывающий
throat : тамак : горло
through : аркылуу : через, сквозь
Thursday : Бейшемби : четверг
ticket : билет : билет
tickets : билеттер : билеты
tidy : тыкан : чистый, аккуратный
tidying : иреттөө : уборка
tie : галстук : связь, связывать, галстук
ties : байланыштар : связи
tight : тыгыз : плотный, крепкий
till : чейин : до
time : убакыт : время, срок
times : жолу : раз
tip : уч : чаевые, давать на “чай”
tire : шина : уставать, надоесть
tired : чарчадым : усталый
to : чейин : предлог, частица инфинитива
toast : тост : тост (жар. хлеб), сушить
today : бүгүн : сегодня, теперь
today’s : бугунку : сегодняшний
together : бирге : вместе, одновременно
toilet : туалет : туалет
told : айтып берди : рассказал, сообщил
tomato : помидор : томат, помидор
tomatoes : помидор : помидоры
tomorrow : эртең : завтра, назавтра
ton : тонна : тонна
tongue : тил : язык
tonight : бүгүн түнү : сегодня вечером
too : да : слишком, тоже
took : алды : брал
toothache : тиш оору : зубная боль
toss : ыргытуу : толчок, сотрясение
total : жалпы : сумма, весь
touch : тийүү : соприкосновение, контакт
tough : катуу : жесткий
tourism : туризм : туризм
tourist : турист : турист(ский)
towel : сүлгү : полотенце
town : шаар : город
toy : оюнчук : игрушка, забавляться
toys : оюнчуктар : игрушки
trade : соода : торговать, ремесло
trading : соода : торговля
traffic : трафик : уличное движение
train : поезд : поезд, привлекать
trains : поезддер : поезда
tram : трамвай : трамвай
transit : транзит : транзит, проезд
translate : которуу : переводить, объяснять
translating : которуу : перевод
transport : транспорт : транспорт, перевозить
travel : саякат : путешествовать
traveled : саякаттады : путешествовал
traveling : Саякаттоо : путешествие
treat : мамиле кылуу : удовольствие, лечить
treated : дарыланган : лечил
trial : сот : попытка, испытание
tried : аракет кылды : пытался
tried on : аракет кылган : мерил
trip : сапар : поездка, экскурсия
trips : сапарлар : поездки
trouble : кыйынчылык : неприятность, беда
troubled : тынчсызданды : побеспокоил
troubles : кыйынчылыктар : неприятности
trousers : шым : брюки
trout : форель : форель
true : чын : правильный, верный
try : аракет кыл : пробовать, пытаться
try on : аракет кыл : примерять (платье)
trying : аракет кылуу : пытающийся
Tuesday : Шейшемби : вторник
turkey : Туркия : индейка
turn : айлануу : поворачивать, вращать
TV : телевизор, телевидение : телевизор, телевидение
twelve : он эки : двенадцать
twenty : жыйырма : двадцать
twenty-five : жыйырма беш : двадцать пять
twice : эки жолу : дважды, вдвое
twin : эгиз : двойной, двойник
two : эки : два
type : түрү : тип, род
typical : типтүү : типичный
tyre : шина : шина
umbrella : кол чатыр : зонт
umbrellas : кол чатырлар : зонты
under : астында : под
underground : жер астындагы : метрополитен, подземный
understand : түшүнүү : понимать, подразумевать
understanding : түшүнүү : понимание
understood : түшүндүм : понимал, понятый
underwear : ич кийим : нижнее белье
undress : чечин : раздеваться
unforgettable : унутулгус : незабываемый
union : союз : союз
unions : профсоюздар : союзы
unit : бирдиги : единица
units : бирдиктер : единицы
university : университет : университет
unlikely : күмөн : маловероятный, вряд ли
unlucky : бактысыз : неудачный
unskilled : квалификациясыз : неквалифицированный
until : чейин : до
unusual : адаттан тыш : необычный
up : өйдө : вверх, до предела, наверху
up to the mark : белгиге чейин : в хорошем состоянии
upon : үстүнө : на
upper : жогорку : верхний
upset : капа : беспорядок, расстройство
us : биз : нас, нам
use : колдонуу : использовать, употребить
used : колдонулган : использованный, подержанный
used to : болгон : раньше делать что-либо
using : колдонуу : пользование
utter : айтуу : издавать (звук), произносить
vacancies : бош орундар : вакансии
vacancy : вакансия : вакансия, пустота
vacant : бош : свободный, незанятый
vacation : каникул : отпуск, каникулы
vaccination : эмдөө : прививка
vain : бекер : напрасный, тщетный
veal : торпок эти : телятина
vegetable : жашылча : овощ, растение
vegetables : жашылчалар : овощи
velocity : ылдамдык : скорость
venture : ишкана : предприятие, риск
ventures : ишканалар : предприятия
verb : этиш : глагол
verbs : этиштер : глаголы
very : абдан : очень, тот самый
vexed : кыжырданган : сердил, раздражал
VHS : үй видеосу : видео для дома
via : аркылуу : через
victory : жеңиш : победа
video : видео : видео
video-player : видео-плеер : видеоплеер
view : көрүү : взгляд, мнение
vinegar : уксус : уксус
violet : кызгылт көк : фиолетовый
violin : скрипка : скрипка
visa : виза : виза
visit : зыярат кылуу : визит, посещать
visited : зыярат кылды : посетил
vivid : жандуу : живой, яркий
voltage : Чыңалуу : напряжение
volume : көлөмү : объем, громкость
wait : күт : ждать, ожидать
waited : күттү : ждал
waiter : официант : официант
waiting : күтүүдө : ожидание
wake : ойгонуу : будить, просыпаться
walk : басуу : гулять, ходить пешком
walked : басып жүрдү : гулял
want : келет : хотеть, желать
wanted : каалаган : хотел, желанный
wants : каалайт : хочет, нуждается в
war : согуш : война, воевать
war-path : согуш жолу : воинственное настроение
warm : жылуу : теплый, согревать
warmer : жылуураак : теплее
warning : эскертүү : предупреждение
was : болгон : был
wash : жуу : мыть, стирать
washed : жууган : мыл, вымытый
waste : таштанды : тратить, использованный
watch : көрүү : часы, смотреть
watches : сааттар : часы
watching : көрүү : просмотр
water : суу : вода, поливать
watermelon : дарбыз : арбуз
way : жол : дорога, путь
we : биз : мы
we’d : биз болмок : мы бы
we’ll : биз алабыз : we will
we’ve : бизде : we have
wear : кийүү : одежда, носить
wearing : кийүү : носящий одежду
weather : аба ырайы : погода
Wednesday : Шаршемби : среда
week : жума : неделя
weekend : дем алыш : выходные
weigh : тараза : взвешивать, весить
weight : салмак : вес, тяжесть
welcome : Кош келдиңиз : желанный, гостеприимство
well : жакшы : хорошо, очень
well-done : мыкты жасалды : хорошо прожаренный
well-paid : жакшы төлөнөт : хорошо оплачиваемый
went : кетти : шел, ехал
were : болгон : были
west : батыш : запад, западный
wet : нымдуу : мокрый
what : эмне : что, какой
what’s : эмне : what is
when : качан : когда
where : кайда : где, куда
which : кайсы : который
while : ал эми : пока, в то время, как
whistle : ышкырык : свистеть, доносить
white : ак : белый
who : ким : кто
whom : ким : кому, кого
whose : кимдики : чей
why : неге : почему
widely : кеңири : широко
widow : жесир : вдова
widower : жесир : вдовец
wife : аял : жена
wife’s : аялынын : жены
wild : жапайы : исступленный, безумный
will : болот : вспомогательный глагол
willingly : каалоо менен : охотно
win : ут : выигрывать, побеждать
wind : шамал : ветер, виток
wind up : шамал : заводить (часы)
windfall : күтүлбөгөн түшүү : неожиданная удача
window : терезе : окно, оконный
windows : терезелер : окна
windy : шамалдуу : ветреный
wine : шарап : вино, винный
wine-card : шарап картасы : карта вин
winter : кыш : зима
wire : зым : переводить телеграфом
wise : акылдуу : мудрый
wish : каалоо : желание, желать
wishes : каалоолор : пожелания
with : менен : с
withdraw : чегинүү : брать назад, забирать
withdrawals : алуулар : выдача багажа
without : жок : без
woke : ойгонду : будил
woken : ойгонду : разбуженный
woman : аял : женщина
women : аялдар : женщины
women’s : аялдардыкы : женский
won : жеңди : победил, побежденный
won’t : болбойт : will not
wonder : таң калуу : удивляться
wonderful : сонун : замечательный, чудесный
woolen : жүн : шерстяной
woollen : жүн : шерстяной
word : сөз : слово, обещание
words : сөздөр : слова
work : иш : работать, делать
worked : иштеген : работал, сработанный
worker : жумушчу : рабочий
working : иштеп жатат : делающий, творящий
world : дүйнө : мир, свет
worry : тынчсыздануу : беспокоиться
worse : жаман : хуже
worth : баалуу : стоящий, заслуживающий
would : болмок : вспомогательный, модальный глагол
would like : жакмак : хотел (и) бы
wrist : билек : наручный, запястье
wrist watch : кол саат : наручные часы
write : жаз : писать, записывать
writer : жазуучу : писатель
wrong : туура эмес : неправильный, не тот
wrote : жазган : писал, написанный
yard : короо : ярд, двор
year : жыл : год
yellow : сары : желтый
yes : ооба : да
yesterday : кечээ : вчера
yogurt : йогурт : йогурт
you : сен : вы, ты
you’d better : сен жакшыраак : вам бы лучше
you’ll : сен кыласың : вы будете
young : жаш : молодой
younger : жаш : моложе
youngest : эң жаш : самый молодой, младший
your : сенин : ваш, твой
yours : сеники : ваш, ваши
yourself : өзүң : сам, сами
youth : жаштар : молодежь
zero : нөл : ноль